1
6
######
#E...#
#.#*.#
#.#..#
#*#..S
######
